11111111111111111111
20011111111111000000
20111111111111000000
20000003300000000000
22222223322222222222
22222223322222222222
20000003300000000000
20000000000000000000
20000000000000000000
20000000000000000000
20000000000000000000
20000000000000000000
20000000000000000000
20000000000000000000
20000000000000000000
20000000000000000000
20000000000000000000
20000000000000000000
20000000000000000000
20000000000000000000