4444444444444444444444
4211111111111111111114
4211111111111111111114
4200000033000000000004
4222222233222222222224
4222222233222222222224
4200000033000000000004
4200000000000000000004
4200000000000000000004
4200000000000000000004
4200000000000000000004
4200000000000000000004
4200000000000000000004
4200000000000000000004
4200000000000000000004
4200000000000000000004
4200000000000000000004
4200000000000000000004
4200000000000000000004
4200000000000000000004
4444444444444444444444
